NO img/tex.png
SO img/tex2.png
WE img/tex3.png
EA img/tex4.png
F  220, 0, 20
C  0, 30, 200

        1111111111111111111111111
        1000000000110000000000001
        1011000001110000000000001
    11111001000001110000000000001
11111111011000001  10000000000001
100000000011000001110111111111111
11110111111111000000000010001
11110111111111011101010010001             
11000000110101011100000010001
1000000000S000001100000010001
10000000000000001101010010001       1 
1100000111010101111101111000111    101
11110111 1110101 101111010001       1
11111111 1111111 111111111111