NO img/TECH_1E.png
SO img/TECH_2f.png
WE img/TECH_3B.png
EA img/TECH_4F.png
F  150, 30, 20
C  20, 70, 150

        1111111111111111111111111
        1000000000110000000000001
        1011000001110000000000001
    11111001000001110000000000001
11111111011000001  10000000000001
100000000011000001110111111111111
11110111111111000000000010001
11110111111111011101010010001             
11000000110101011100000010001
1000000000S000001100000010001
10000000000000001101010010001       1 
1100000111010101111101111000111    101
11110111 1110101 101111010001       1
11111111 1111111 111111111111
