NO img/BRICK_3D.PNG
SO img/BRICK_3B.PNG
WE img/BRICK_6D.PNG
EA img/BRICK_4A.PNG
F  150, 30, 20
C  20, 70, 150

1111111
1N11111
1111111