NO img/TECH_1C.PNG
EA img/TECH_1E.PNG
SO img/TECH_2f.png
WE img/TECH_3B.PNG
F  150, 30, 20
C  20, 70, 150


                  



                         1
        1111111111111111111111111
        1000000000110000000000001
        1011000000000000000000001
    11111001000001110000000000001
11111111000000001  10000000000001
100000000011000001110111110111111
10111111111111000000000010001     
1011       111001001010010001             
10011111111111010101010010001             
10000000110101001000000010001
10000S00000000001100000000001
10000010000000001101010010001       1 
1100000111010101111101111000111    101
11110111 1110101 101111010001       1
11111111 1111111 111111111111                         1
        1111111111111111111111111
        1000000000110000000000001
        1011000000000000000000001
    11111001000001110000000000001
11111111000000001  10000000000001
100000000011000001110111110111111
10111111111111000000000010001     
1011       111001001010010001             
10011111111111010101010010001             
10000000110101001000000010001
10000010000000001101010010001       1 
1100000111010101111101111000111    101
11110111 1110101 101111010001       1
11111111 1111111 111111111111                         1
        1111111111111111111111111
        1000000000110000000000001
        1011000000000000000000001
    11111001000001110000000000001
11111111000000001  10000000000001
100000000011000001110111110111111
10111111111111000000000010001     
1011       111001001010010001             
10011111111111010101010010001             
10000000110101001000000010001
10000010000000001101010010001       1 
1100000111010101111101111000111    101
11110111 1110101 101111010001       1
11111111 1111111 111111111111                         1
        1111111111111111111111111
        1000000000110000000000001
        1011000000000000000000001
    11111001000001110000000000001
11111111000000001  10000000000001
100000000011000001110111110111111
10111111111111000000000010001     
1011       111001001010010001             
10011111111111010101010010001             
10000000110101001000000010001
10000010000000001101010010001       1 
1100000111010101111101111000111    101
11110111 1110101 101111010001       1
11111111 1111111 111111111111                         1
        1111111111111111111111111
        1000000000110000000000001
        1011000000000000000000001
    11111001000001110000000000001
11111111000000001  10000000000001
100000000011000001110111110111111
10111111111111000000000010001     
1011       111001001010010001             
10011111111111010101010010001             
10000000110101001000000010001
10000010000000001101010010001       1 
1100000111010101111101111000111    101
11110111 1110101 101111010001       1
11111111 1111111 111111111111

                         1
        1111111111111111111111111
        1000000000110000000000001
        1011000000000000000000001
    11111001000001110000000000001
11111111000000001  10000000000001
100000000011000001110111110111111
10111111111111000000000010001     
1011       111001001010010001             
10011111111111010101010010001             
10000000110101001000000010001
10000010000000001101010010001       1 
1100000111010101111101111000111    101
11110111 1110101 101111010001       1
11111111 1111111 111111111111